############################
#T#       T # P    D      I#
#   ## #   X#B B###O#  #####
##    # ##### B ###### ## T#
#  ## # #           #T# #T #
# #    ##   B   B   #  ##  #
##  # # #F  #   #  F#  #  ##
#   #  ######   ##### ## # #
# #    K  OT#   #T         #
#### ########   ####### ####
#      E  #       E        #
# E           #            #
#   T     S #   #          #
#    E                 T   #
#            # #           #
#F  E       #TFT#   E     F#
############################